1,0,2,3,1,2,3,2,2,2,3,2,1,2,3,2,
1,2,2,3,2,4,2,2,3,4,2,2,1,2,3,3,
1,0,2,3,1,2,3,2,2,2,3,2,1,2,3,2,
1,2,2,3,2,4,2,2,3,4,2,2,1,2,3,3,
1,0,2,3,1,2,3,2,2,2,3,2,1,2,3,2,
1,2,2,3,2,4,2,2,3,4,2,2,1,2,3,3,
1,0,2,3,1,2,3,2,2,2,3,2,1,2,3,2,
1,2,2,3,2,4,2,2,3,4,2,2,1,2,3,3,
1,0,2,3,1,2,3,2,2,2,3,2,1,2,3,2,
1,2,2,3,2,4,2,2,3,4,2,2,1,2,3,3,
1,0,2,3,1,2,3,2,2,2,3,2,1,2,3,2,
1,2,2,3,2,4,2,2,3,4,2,2,1,2,3,3